0202020202020202020202020202020203030303030303030303030303030303030303030303030303030303030303030202020202020202020202020202020200000000000000000000000000000000000000000000000000000000000000000000000000000000000000000000000000000000000000000000000000000000
020f0101010d01010707020801c00e0203030303030303030303030303030303030000000000000000000000000000030202020202020202020202020202020200000000000000000000000000000000000000000000000000000000000000000000000000000000000000000000000000000000000000000000000000000000
02010101070201010707020101c0c00203030303030303030303030303030303030000001011111111111200000000030202020202020202020202020202020200000000000000000000000000000000000000000000000000000000000000000000000000000000000000000000000000000000000000000000000000000000
0201010108020801010102010101010203030303030310111203030303030303030000002002020202022200000000030202020202020202020202020202020200000000000000000000000000000000000000000000000000000000000000000000000000000000000000000000000000000000000000000000000000000000
02010101080208010108020707010102030303101111240e2311111203030303030000002002050205022200000003030202020202020202020202020202020200000000000000000000000000000000000000000000000000000000000000000000000000000000000000000000000000000000000000000000000000000000
020101010102020d0202020202020d0203030320040445444504042203030303030000002004040404042200000003030202020202020202020202020202020200000000000000000000000000000000000000000000000000000000000000000000000000000000000000000000000000000000000000000000000000000000
02080101080201010102010d01010102030303204a01444444014b22030303030303000020014d4e4f012200000003030202020202020202020202020202020200000000000000000000000000000000000000000000000000000000000000000000000000000000000000000000000000000000000000000000000000000000
0208010808020101010201020d020202030303204001440644014322030303030303000020015d5e5f012200000003030202020202020202020202020202020200000000000000000000000000000000000000000000000000000000000000000000000000000000000000000000000000000000000000000000000000000000
02020d02020201c001020102c0c00802030303204801444444010122030303030303000020016d6e6f012200000000030202020202020202020202020202020200000000000000000000000000000000000000000000000000000000000000000000000000000000000000000000000000000000000000000000000000000000
01010101010d0101010201020101010203030320070101010101072203030303030000002001010101012200000000030202020202020202020202020202020200000000000000000000000000000000000000000000000000000000000000000000000000000000000000000000000000000000000000000000000000000000
0d02020202020101010201020101010203030320080701010108082203030303030000003014010101133200000000030202020202020202020202020202020200000000000000000000000000000000000000000000000000000000000000000000000000000000000000000000000000000000000000000000000000000000
0101010102020d02020201020101010203030330313114011331313203030303030000000020010f01220000000003030202020202020202020202020202020200000000000000000000000000000000000000000000000000000000000000000000000000000000000000000000000000000000000000000000000000000000
01010101020101010102010d010a0102030303030303200f2203030303030303030000000030313131320000000003030202020202020202020202020202020200000000000000000000000000000000000000000000000000000000000000000000000000000000000000000000000000000000000000000000000000000000
0101010102010c01c0020102c001010203030303030330313203030303030303030000000000000000000000000000030202020202020202020202020202020200000000000000000000000000000000000000000000000000000000000000000000000000000000000000000000000000000000000000000000000000000000
010101010d01c001010d01020101070203030303030303030303030303030303030000000000000000000000000000030202020202020202020202020202020200000000000000000000000000000000000000000000000000000000000000000000000000000000000000000000000000000000000000000000000000000000
0202020202020202020202020202020203030303030303030303030303030303030303030303030303030303030303030202020202020202020202020202020200000000000000000000000000000000000000000000000000000000000000000000000000000000000000000000000000000000000000000000000000000000
