0000000000000000000000000000000000000000000000000000000000000000000000000000000000000000000000000000000000000000000000000000005d09000900090009430000000000000000000000000000000000000000000000000000000000000000000000000000000000000000000000000000000000002828
0000000000000000000000000000000000000000000000000000000000000000000000000000000000000000000000000000000000000000000000000000000909070809090909090000000000000000000000000000000000000000000000000000000000000000000000000000000000000000000000000000000000392828
000000000000000000000000000000000000000000000000000000000000000000000000000000000000000000000000000000004000000000000000000000090a0a0a0a0a0a0a0a0000000000000000000000000000000000000000000000000000000000000000000000000000000000000000000000000000000018282828
000000000000000000000000000000000000000000000000000000000000000000000000000000000000000000000000000000000000000000000000000000090a0a0a440a0a0a0b0000000000000000000000000000000000000000000000000000000000000000004400000000000000000000000000000043003928282828
43000000000000000000000000000000000000000000000000000036292929293700000000003629293700000000000000000000000005000000000000000009700a440a440a0b0d0000000000000000430000000000000000000000000000000000000000000000443044000000000000000000000000700000002828282828
292929370000000000000000000000000000000000000000000000282728272627000000000027282627000000000000000025170000140000000000000000090a0a0a440a0b0d0d0000000000000000000000000000000000000000000000000000000000000000004400000000000000000000000000000018002728282828
282726270000000000000000000000000000000000000000000000272628282728000006000027282728000000740000000003030303030000000000000000090a0a0a0a0b0d0d0d0000000000000000000000000000000000000000000000000000000000000000000000000000000000000000000005000027392828412828
282828280000000000000000000000000000000000430000000000282827282726000000000028272827000000000000391802210202023939180000000000090a0a0a0b0d0d0c090000000000000000000000000000000000000000000000000000000000000500000000000000000000000000000014180027282828282826
282827280000000000000000000000000000000630060000000000262828282827000000000038383838003918391839282802020224022828283939180000090708090907080909170000050000000000000000000000000000000000000000000000000000140000000000000000000000000000003928002828380e0e0e38
2728272600000000000000000000000000000006060600000000003838383838380000000000001213703938063038382828202020202028282728282818000303030303030303030300391400000000000000000000000000000000000000000500000000001405000000000000000004000000251828281803030303030303
2828282700000000000000000000000000000000000000000000000000121300000070000003030303030303030303032828282828282827282728282828392002232020202002200239273900000000000000000000000630000000000005001405000000051414000000000000000014180000142828282802020202020202
3838383800000000000000000000000000000500000000000000030303030303030303030302020202020202020202022828282828282728272828282828280606062828282828282827282818030303030300000070000606000000050014001414000000141414000000000000000039270000392827280602202002022002
1213172500480000000000000400060000001425000000700017020220200202020202020202022002020202202302023838383838383838383838383838380606063870387038703870383838020202020203030303030303007000140414001414000404141414005200000000001738383917383838300602022002240202
0303030303030303030303030303030303030303030303030303020202020202020202020202022320020220200202020303030303030303030303030303030303030303030303030303030303020202020202022002020202030303030303030303030303030303030303030303030303030303030303030302022320020202
2002020202210202020202020202220202020202020220200221020202022002200202230202020202020202200202020220020202020202020202020202020202020202020202020202020202200202200202020202230202020202020202022002020223020202020202022002020202022002022020200202020202202002
0223200220202002020220202102020202200202020202202002020202020202202002022120022102020202022420020202020202020202020202202002022002020220200220200202202020022002200202020202020202022302020202200202020202020202020202230202020202020202020202200202020220200202
0000000000000000000000000000000000000000000000000000000000001400140000000000000000140014000014000014140000140014000014000000001400000000000000000000000000000000000000000000000000000000000000000000000000000000000000000000000000000000000000000000000000000000
0000000000000000000000000000000000000000000000000000000000001400140000000000000000140014000014000014140000140014000014000000001400000000000000000000000000000000000000000000000000000000000000000000000000000000000000000000000000000000000000000000000000000000
0000000000000000000000000000000000000000000000000000000000001400140000000000000000000014000014000014140000140014000014000000000000000000000000000000000000000000000000000000000000000000000000000000000000000000000000000000000000000000000000000000000000000000
0000000000000000000000000000000000000000000000000000000000000000140000000000000000000014000014000014140000140014000014000000000000000000000000000000000000000000000000000000000000000000000000000000000000000000000000000000000000000000000000000000000000000000
0000000000000000000000000000000000000000000000000000000000000000140000000000000000000000000014000014140000140014000014000000000000000000000000000000000000000000000000000000000000000000000000000000000000000000000000000000000000000000000000000000000000000000
0000000000000000000000000000000000000000000000000000000000000000000000000000000000000000000014000014140000000014000014000000000000000000000000000000000000000000000000000000000000000000000000000000000000000000000000000000000000000000000000000000000000000000
0000000000000000000000000000000000000000000000000000000000000000000000000000000000000000000000000014000000000014000000000000000000000000000000000000000000000000000000000000000000000000000000000000000000000000000000000000000000000000000000000000000000000000
0000000000000000000000000000000000000000000000000000000000000000000000000000000000000000000000000014000000000000000000000000000000000000000000000000000000000000000000000000000000000000000000000000000000000000000000000000000000000000000000000000000000000000
1800000000000000000000000000000000000000000000000000000000000000000000000000000000000000000000000000000000000000000000000000000000000000000000000000000000000000000000000000000000000000000000000000000000000000000000000000000000000000000000000000000000000000
2805000000000000000000000000000000000000000000000000000000000000000000000000000000000000000000000000000000000000000000000000000000000000000000000000000000000000000000000000000000000000000000000000000000000000000000000000000000000000000000000000000000000000
2739180000000000000000000000000000000000000000000000000000000000000000000000000000000000000000000000000000000000000000000000000000000000000000000000000000000000000000000000000000000000000000000000000000000000000000000000000000000000000000000000000000000000
4828270017170400000000190000000000000000000000000000000000000000000000000000000000000000000000000000000000000000000000000000000000000000000000000000000000000000000000000000000000000000000000000000000000000000000000000000000000000000000000000000000000000000
292929292929291a1a1a29292900000000000000000000000000000000000000000000000000000000000000000000000000000000000000000000000000000000000000000000000000000000000000000000000000000000000000000000000000000000000000000000000000000000000000000000000000000000000000
0101010101010104000001010100000000000000000000000000000000000000000000000000000000000000000000000000000000000000000000000000000000000000000000000000000000000000000000000000000000000000000000000000000000000000000000000000000000000000000000000000000000000000
0202020202200214050002020200000000000000000000000000000000000000000000000000000000000000000000000000000000000000000000000000000000000000000000000000000000000000000000000000000000000000000000000000000000000000000000000000000000000000000000000000000000000000
2002202002020214140002020200000000000000000000000000000000000000000000000000000000000000000000000000000000000000000000000000000000000000000000000000000000000000000000000000000000000000000000000000000000000000000000000000000000000000000000000000000000000000
