0202020202020202020202020202020202020202020202020202020202020202050505050505050505050505050505050202020202020202020202020202020200000000000000000000000000000000000000000000000000000000000000000000000000000000000000000000000000000000000000000000000000000000
020f0101010d01010707020801c00e0202020202020202020202020202020202050000000000000000000000000000050202020202020202020202020202020200000000000000000000000000000000000000000000000000000000000000000000000000000000000000000000000000000000000000000000000000000000
02010101070201010707020101c0c00202020202020210111202020202020202050000000000000000000000000000050202020202020202020202020202020200000000000000000000000000000000000000000000000000000000000000000000000000000000000000000000000000000000000000000000000000000000
02010101080208010101020101010102020202020202200e2202020202020202050000000000000000000000000000050202020202020202020202020202020200000000000000000000000000000000000000000000000000000000000000000000000000000000000000000000000000000000000000000000000000000000
0201010108020801010802070701010202020210111124012311111202020202050000000000000000000000000000050202020202020202020202020202020200000000000000000000000000000000000000000000000000000000000000000000000000000000000000000000000000000000000000000000000000000000
020101010102020d0202020202020d0202020220010101010101012202020202050000000002020202020200000000050202020202020202020202020202020200000000000000000000000000000000000000000000000000000000000000000000000000000000000000000000000000000000000000000000000000000000
02080101080201010102010d0101010202020220010101010101012202020202050000000002010101010200000000050202020202020202020202020202020200000000000000000000000000000000000000000000000000000000000000000000000000000000000000000000000000000000000000000000000000000000
0208010808020101010201020d02020202020220010101060101012202020202050000000002010601010200000000050202020202020202020202020202020200000000000000000000000000000000000000000000000000000000000000000000000000000000000000000000000000000000000000000000000000000000
02020d02020201c001020102c0c0080202020220010101010101012202020202050500000002010101010200000000050202020202020202020202020202020200000000000000000000000000000000000000000000000000000000000000000000000000000000000000000000000000000000000000000000000000000000
01010101010d0101010201020101010202020220070101010101072202020202050000000002010101010200000000050202020202020202020202020202020200000000000000000000000000000000000000000000000000000000000000000000000000000000000000000000000000000000000000000000000000000000
0d02020202020101010201020101010202020220080701010108082202020202050000000002020201020200000000050202020202020202020202020202020200000000000000000000000000000000000000000000000000000000000000000000000000000000000000000000000000000000000000000000000000000000
0101010102020d02020201020101010202020230313114011331313202020202050000000000020f01020000000000050202020202020202020202020202020200000000000000000000000000000000000000000000000000000000000000000000000000000000000000000000000000000000000000000000000000000000
01010101020101010102010d010a0102020202020202200f2202020202020202050000000000020202020000000000050202020202020202020202020202020200000000000000000000000000000000000000000000000000000000000000000000000000000000000000000000000000000000000000000000000000000000
0101010102010c01c0020102c001010202020202020230313202020202020202050000000000000000000000000000050202020202020202020202020202020200000000000000000000000000000000000000000000000000000000000000000000000000000000000000000000000000000000000000000000000000000000
010101010d01c001010d01020101070202020202020202020202020202020202050000000000000000000000000000050202020202020202020202020202020200000000000000000000000000000000000000000000000000000000000000000000000000000000000000000000000000000000000000000000000000000000
0202020202020202020202020202020202020202020202020202020202020202050505050505050505050505050505050202020202020202020202020202020200000000000000000000000000000000000000000000000000000000000000000000000000000000000000000000000000000000000000000000000000000000
